11111111111
10000000111
10111110111
10001010111
10111010111
10100010111
10101110111
10101000111
10101111111
10001010001
10111010111
10100010111
10101110111
10100000111
10101110111
10100010111
10111110111
10000000111
11111111111