11111111111
10111111111
10111111111
10111111111
10111111111
10111111111
10111111111
10000000001
11111111111