1111111111111111111
1011111111111111111
1011111111111111111
1011111111111111111
1011111111111111111
1000000000000000001
1011111111111111111
1011111111111111111
1011111111111111111
1000000000111111111
1111111110111111111
1111111110111111111
1111111110111111111
1110000000111111111
1111111111111111111