1111111111111111111111111
1000000000000000000000001
1011111111111111111111101
1000001000001000000000001
1011101111101111111110101
1010100000100000000000101
1010101111101111111110101
1010100000000000000000101
1010101111101111111110111
1010000000001000000010101
1011111111111111111110101
1000001000000000000000001
1111111111111111111111111